a.user|a.choice|b.user|b.choice|end
internet_friends|Hit the gas|platonic_void|Swerve|/u/internet_friends gets to call /u/platonic_void a chicken.
newme274|Swerve|skretsch|Swerve|Both /u/newme274 and /u/skretsch safely swerve.
emmanation|Swerve|femma|Hit the gas|/u/femma gets to call /u/emmanation a chicken.
tlmb0|Swerve|statguy|Swerve|Both /u/tlmb0 and /u/statguy safely swerve.
hugesf|Swerve|dottydani|Swerve|Both /u/hugesf and /u/dottydani safely swerve.
lightraie|Swerve|theferretmafialeader|Swerve|Both /u/lightraie and /u/theferretmafialeader safely swerve.
h3be_|Swerve|cloneman95|Hit the gas|/u/cloneman95 gets to call /u/h3be_ a chicken.
redpon3|Hit the gas|omega_weapon85|Hit the gas|Both /u/redpon3 and /u/omega_weapon85 crash and die.
lemmyk|Swerve|lokmanohands|Hit the gas|/u/lokmanohands gets to call /u/lemmyk a chicken.
_eggpiant_|Hit the gas|gerard_bebru|Swerve|/u/_eggpiant_ gets to call /u/gerard_bebru a chicken.
dirtydan413|Swerve|mrballoon_hands|Swerve|Both /u/dirtydan413 and /u/mrballoon_hands safely swerve.
kanimaki|Swerve|bork_lesnar|Swerve|Both /u/kanimaki and /u/bork_lesnar safely swerve.
klatuu_barada_nikto|Swerve|gummybee|Swerve|Both /u/klatuu_barada_nikto and /u/gummybee safely swerve.
gonumen|Hit the gas|edihau|Swerve|/u/gonumen gets to call /u/edihau a chicken.
seriyes|Swerve|public_compliance|Swerve|Both /u/seriyes and /u/public_compliance safely swerve.
thatwriterfriend|Swerve|thomas6785|Swerve|Both /u/thatwriterfriend and /u/thomas6785 safely swerve.
enjoyslongwalks|Swerve|etherealphoenix|Hit the gas|/u/etherealphoenix gets to call /u/enjoyslongwalks a chicken.
jompeter01|Swerve|milliebirdie|Swerve|Both /u/jompeter01 and /u/milliebirdie safely swerve.
xaplostras|Swerve|alissaluvsdogs|Swerve|Both /u/xaplostras and /u/alissaluvsdogs safely swerve.
finbarwrong|Hit the gas|theinvisibleduck|Hit the gas|Both /u/finbarwrong and /u/theinvisibleduck crash and die.
rara623|Swerve|dermaxpower|Swerve|Both /u/rara623 and /u/dermaxpower safely swerve.
mistressliliana|Swerve|bewaretwo|Swerve|Both /u/mistressliliana and /u/bewaretwo safely swerve.
jingah|Swerve|mentos68|Hit the gas|/u/mentos68 gets to call /u/jingah a chicken.
pm_meyourcoffee|Hit the gas|incrediblestrawberry|Swerve|/u/pm_meyourcoffee gets to call /u/incrediblestrawberry a chicken.
krtkneki|Hit the gas|crocostix|Hit the gas|Both /u/krtkneki and /u/crocostix crash and die.
sovietvvinter|Swerve|zajun|Swerve|Both /u/sovietvvinter and /u/zajun safely swerve.
lycan_trophy|Swerve|sbs401|Hit the gas|/u/sbs401 gets to call /u/lycan_trophy a chicken.
fire1299|Swerve|bell123456|Hit the gas|/u/bell123456 gets to call /u/fire1299 a chicken.
scholar_requesting|Swerve|throwaway133379001|Swerve|Both /u/scholar_requesting and /u/throwaway133379001 safely swerve.
nstarz|Hit the gas|p0tet|Hit the gas|Both /u/nstarz and /u/p0tet crash and die.
ninchnate|Swerve|chthonicirrigation|Swerve|Both /u/ninchnate and /u/chthonicirrigation safely swerve.
auramgold|Swerve|fallon758|Swerve|Both /u/auramgold and /u/fallon758 safely swerve.
latdropking|Swerve|tkaish|Swerve|Both /u/latdropking and /u/tkaish safely swerve.
awsumpizzadude|Swerve|pablothemexican7|Swerve|Both /u/awsumpizzadude and /u/pablothemexican7 safely swerve.
boltkey|Swerve|skarm137|Swerve|Both /u/boltkey and /u/skarm137 safely swerve.
harambe_milkbabys|Hit the gas|1585881|Swerve|/u/harambe_milkbabys gets to call /u/1585881 a chicken.
sofiboy|Hit the gas|perntdoast|Hit the gas|Both /u/sofiboy and /u/perntdoast crash and die.
miss-robot|Swerve|blooor|Hit the gas|/u/blooor gets to call /u/miss-robot a chicken.
scarlet88|Swerve|aaaninjaman|Hit the gas|/u/aaaninjaman gets to call /u/scarlet88 a chicken.
moithirteen|Swerve|topol_m1|Swerve|Both /u/moithirteen and /u/topol_m1 safely swerve.
hushsquared|Swerve|noja|Swerve|Both /u/hushsquared and /u/noja safely swerve.
65rytg|Hit the gas|apflamous|Hit the gas|Both /u/65rytg and /u/apflamous crash and die.
grkpgn|Swerve|sdsafdf|Hit the gas|/u/sdsafdf gets to call /u/grkpgn a chicken.
cocochica33|Swerve|the_kazaakplethkilik|Swerve|Both /u/cocochica33 and /u/the_kazaakplethkilik safely swerve.
luncos|Swerve|arthuresque|Swerve|Both /u/luncos and /u/arthuresque safely swerve.
steaknsteak|Swerve|shining_|Swerve|Both /u/steaknsteak and /u/shining_ safely swerve.
browniebrown|Hit the gas|ssabeth|Hit the gas|Both /u/browniebrown and /u/ssabeth crash and die.
jmcalla|Swerve|negativedeadbabies|Swerve|Both /u/jmcalla and /u/negativedeadbabies safely swerve.
4rewq|Hit the gas|joejoemojo|Swerve|/u/4rewq gets to call /u/joejoemojo a chicken.
elvysaur|Swerve|legolaslegolass|Hit the gas|/u/legolaslegolass gets to call /u/elvysaur a chicken.
mrpilotgamer|Swerve|-top-chicken-|Swerve|Both /u/mrpilotgamer and /u/-top-chicken- safely swerve.
macbeth554|Swerve|t78lego|Swerve|Both /u/macbeth554 and /u/t78lego safely swerve.
calibaan|Hit the gas|gintarazimu|Swerve|/u/calibaan gets to call /u/gintarazimu a chicken.
mrdugong|Hit the gas|alaskansky|Swerve|/u/mrdugong gets to call /u/alaskansky a chicken.
kashthealien|Swerve|a5yl|Hit the gas|/u/a5yl gets to call /u/kashthealien a chicken.
jaclekiller|Swerve|d|Swerve|Both /u/jaclekiller and /u/d safely swerve.
azurefishnets|Swerve|nullomore|Swerve|Both /u/azurefishnets and /u/nullomore safely swerve.
dalibar|Swerve|legosp7|Hit the gas|/u/legosp7 gets to call /u/dalibar a chicken.
bitch_is_cray_cray|Hit the gas|unicornbomber|Hit the gas|Both /u/bitch_is_cray_cray and /u/unicornbomber crash and die.
jacobepping|Hit the gas|toastiify|Hit the gas|Both /u/jacobepping and /u/toastiify crash and die.
a_dam_ste|Swerve|dinomannitro6|Swerve|Both /u/a_dam_ste and /u/dinomannitro6 safely swerve.
iampasiphae|Hit the gas|passerby5|Swerve|/u/iampasiphae gets to call /u/passerby5 a chicken.
genericusernameno2|Swerve|whisdeth|Swerve|Both /u/genericusernameno2 and /u/whisdeth safely swerve.
coltonhoover|Swerve|tatertalker|Hit the gas|/u/tatertalker gets to call /u/coltonhoover a chicken.
noobhunter777|Swerve|altoidian|Swerve|Both /u/noobhunter777 and /u/altoidian safely swerve.
mm1491|Swerve|seaweed62393|Hit the gas|/u/seaweed62393 gets to call /u/mm1491 a chicken.
mihan117|Swerve|pm_me_cute_pugs|Swerve|Both /u/mihan117 and /u/pm_me_cute_pugs safely swerve.
dragonheart000|Hit the gas|etk canadian|Hit the gas|Both /u/dragonheart000 and /u/etk canadian crash and die.
zonination|Hit the gas|xor50|Hit the gas|Both /u/zonination and /u/xor50 crash and die.
kerune|Hit the gas|97ft|Hit the gas|Both /u/kerune and /u/97ft crash and die.
amazinglyawesomename|Swerve|wheatking01|Hit the gas|/u/wheatking01 gets to call /u/amazinglyawesomename a chicken.
henricy|Hit the gas|vowelss|Swerve|/u/henricy gets to call /u/vowelss a chicken.
telepac|Hit the gas|spectral-k|Swerve|/u/telepac gets to call /u/spectral-k a chicken.
marceloardz|Hit the gas|summertime214|Swerve|/u/marceloardz gets to call /u/summertime214 a chicken.
davidthewalkerx|Swerve|thatyahoo|Hit the gas|/u/thatyahoo gets to call /u/davidthewalkerx a chicken.
spacejunk444|Swerve|youcalled911forthat|Hit the gas|/u/youcalled911forthat gets to call /u/spacejunk444 a chicken.
survivevivrus|Swerve|tridentboy|Hit the gas|/u/tridentboy gets to call /u/survivevivrus a chicken.
bobito5|Hit the gas|cg5|Hit the gas|Both /u/bobito5 and /u/cg5 crash and die.
jeray2000|Swerve|redeyedchester|Hit the gas|/u/redeyedchester gets to call /u/jeray2000 a chicken.
bdazbty|Hit the gas|nat-cat|Swerve|/u/bdazbty gets to call /u/nat-cat a chicken.
tenebrls|Hit the gas|chackk|Swerve|/u/tenebrls gets to call /u/chackk a chicken.
bizarrefetalkoala|Swerve|-rosemallow|Swerve|Both /u/bizarrefetalkoala and /u/-rosemallow safely swerve.
alecksphillips|Swerve|shastafargo|Swerve|Both /u/alecksphillips and /u/shastafargo safely swerve.
firejoule|Swerve|elitepenguin4|Hit the gas|/u/elitepenguin4 gets to call /u/firejoule a chicken.
triplesock|Swerve|zackattackz|Swerve|Both /u/triplesock and /u/zackattackz safely swerve.
jslev9|Swerve|numberlesswake|Swerve|Both /u/jslev9 and /u/numberlesswake safely swerve.
xangria|Swerve|zantary|Swerve|Both /u/xangria and /u/zantary safely swerve.
swagmasterrs|Swerve|thewalkinggnome|Hit the gas|/u/thewalkinggnome gets to call /u/swagmasterrs a chicken.
hypergraphia|Swerve|valske|Hit the gas|/u/valske gets to call /u/hypergraphia a chicken.
reneiren|Swerve|kiribatii|Hit the gas|/u/kiribatii gets to call /u/reneiren a chicken.
screamingvulcan|Hit the gas|400_lux|Swerve|/u/screamingvulcan gets to call /u/400_lux a chicken.
onlytoask|Swerve|eyebrowsforeveryone|Swerve|Both /u/onlytoask and /u/eyebrowsforeveryone safely swerve.
ispent10minutes|Hit the gas|spectreshep|Swerve|/u/ispent10minutes gets to call /u/spectreshep a chicken.
pili_in_ibiza|Swerve|ravistay|Hit the gas|/u/ravistay gets to call /u/pili_in_ibiza a chicken.
xtarification|Swerve|flyingmonkeyssaymoo|Swerve|Both /u/xtarification and /u/flyingmonkeyssaymoo safely swerve.
ser_scribbles|Swerve|natevh1|Swerve|Both /u/ser_scribbles and /u/natevh1 safely swerve.
k_a_r_m_a_r_a|Swerve|imlikesocool|Swerve|Both /u/k_a_r_m_a_r_a and /u/imlikesocool safely swerve.
internetadventurer|Swerve|hunter5226|Swerve|Both /u/internetadventurer and /u/hunter5226 safely swerve.
clony85|Swerve|crenaani|Hit the gas|/u/crenaani gets to call /u/clony85 a chicken.
moderatelysalted|Hit the gas|pepsilover1|Hit the gas|Both /u/moderatelysalted and /u/pepsilover1 crash and die.
cookieburger|Hit the gas|luctations|Hit the gas|Both /u/cookieburger and /u/luctations crash and die.
sammyterrybelzer|Hit the gas|endemiclegacy|Hit the gas|Both /u/sammyterrybelzer and /u/endemiclegacy crash and die.
pricelesshats|Swerve|kmrst|Hit the gas|/u/kmrst gets to call /u/pricelesshats a chicken.
azazelsheep|Hit the gas|dagsaroni|Swerve|/u/azazelsheep gets to call /u/dagsaroni a chicken.
orthanit|Hit the gas|andydandy162|Hit the gas|Both /u/orthanit and /u/andydandy162 crash and die.
rhazior|Swerve|gandalftheultraviole|Hit the gas|/u/gandalftheultraviole gets to call /u/rhazior a chicken.
quiethi|Hit the gas|weston1108|Swerve|/u/quiethi gets to call /u/weston1108 a chicken.
rhyschew|Hit the gas|mclovins_6|Swerve|/u/rhyschew gets to call /u/mclovins_6 a chicken.
hellsing73|Hit the gas|jverkovykh|Hit the gas|Both /u/hellsing73 and /u/jverkovykh crash and die.
rthztzfhuztfhu|Swerve|avarangian|Hit the gas|/u/avarangian gets to call /u/rthztzfhuztfhu a chicken.
balletscience|Swerve|not_a_plane_either|Hit the gas|/u/not_a_plane_either gets to call /u/balletscience a chicken.
bear_cop|Hit the gas|craggolly|Hit the gas|Both /u/bear_cop and /u/craggolly crash and die.
aloneapart|Swerve|penis|Hit the gas|/u/penis gets to call /u/aloneapart a chicken.
tj6795|Hit the gas|nephdaddy8|Swerve|/u/tj6795 gets to call /u/nephdaddy8 a chicken.
backdoor_sliders|Hit the gas|onesixtyseven|Swerve|/u/backdoor_sliders gets to call /u/onesixtyseven a chicken.
goatcrew|Swerve|skysheena|Swerve|Both /u/goatcrew and /u/skysheena safely swerve.
graviton_beam|Swerve|wakub|Hit the gas|/u/wakub gets to call /u/graviton_beam a chicken.
briannasaurusrex92|Swerve|strattonschippers|Swerve|Both /u/briannasaurusrex92 and /u/strattonschippers safely swerve.
twitchy775|Hit the gas|cyberrubyfox|Swerve|/u/twitchy775 gets to call /u/cyberrubyfox a chicken.
dwightallright|Swerve|redtheta|Swerve|Both /u/dwightallright and /u/redtheta safely swerve.
shaveslavers|Hit the gas|pohtahtohg|Swerve|/u/shaveslavers gets to call /u/pohtahtohg a chicken.
anaglypta|Swerve|hangmanchamp|Hit the gas|/u/hangmanchamp gets to call /u/anaglypta a chicken.
yourmomisawhorehole|Swerve|yusaharri|Swerve|Both /u/yourmomisawhorehole and /u/yusaharri safely swerve.
crappylaptop|Swerve|reoll|Swerve|Both /u/crappylaptop and /u/reoll safely swerve.
ginopono|Hit the gas|ruschnav|Hit the gas|Both /u/ginopono and /u/ruschnav crash and die.
christmascheer23|Hit the gas|lonelyoldcatlady|Swerve|/u/christmascheer23 gets to call /u/lonelyoldcatlady a chicken.
brennifer|Swerve|netherlewis|Swerve|Both /u/brennifer and /u/netherlewis safely swerve.
nosdarb|Swerve|vanarn|Hit the gas|/u/vanarn gets to call /u/nosdarb a chicken.
sir_plus|Swerve|captain_cobra24|Hit the gas|/u/captain_cobra24 gets to call /u/sir_plus a chicken.
emcee_squared|Swerve|vukrum|Swerve|Both /u/emcee_squared and /u/vukrum safely swerve.
soupnugget|Swerve|nemesys2005|Swerve|Both /u/soupnugget and /u/nemesys2005 safely swerve.
homoredditus|Hit the gas|apoptopsicle|Swerve|/u/homoredditus gets to call /u/apoptopsicle a chicken.
anotherturingmachine|Swerve|unitconversion|Swerve|Both /u/anotherturingmachine and /u/unitconversion safely swerve.
bwananabwanana|Hit the gas|songstressindistress|Swerve|/u/bwananabwanana gets to call /u/songstressindistress a chicken.
15goku|Swerve|lordllamahat|Swerve|Both /u/15goku and /u/lordllamahat safely swerve.
evilsalmon|Hit the gas|mynameisclaire|Swerve|/u/evilsalmon gets to call /u/mynameisclaire a chicken.
mongooset|Hit the gas|ctclif|Hit the gas|Both /u/mongooset and /u/ctclif crash and die.
lacoguil|Hit the gas|gresskarpai|Swerve|/u/lacoguil gets to call /u/gresskarpai a chicken.
hollybv|Swerve|nauntynienel|Hit the gas|/u/nauntynienel gets to call /u/hollybv a chicken.
crunchyapples|Swerve|iminabox|Swerve|Both /u/crunchyapples and /u/iminabox safely swerve.
bookworm144|Hit the gas|johnnysmart|Swerve|/u/bookworm144 gets to call /u/johnnysmart a chicken.
usespython|Swerve|makingitpurple|Swerve|Both /u/usespython and /u/makingitpurple safely swerve.
blmzd|Swerve|-pikajew|Hit the gas|/u/-pikajew gets to call /u/blmzd a chicken.
the_future_is_wild|Hit the gas|catriona27|Swerve|/u/the_future_is_wild gets to call /u/catriona27 a chicken.
leninacrowne94|Swerve|scubaduck|Hit the gas|/u/scubaduck gets to call /u/leninacrowne94 a chicken.
theakkez|Hit the gas|nerosmith|Hit the gas|Both /u/theakkez and /u/nerosmith crash and die.
schutterke|Swerve|flaming_pulsar|Swerve|Both /u/schutterke and /u/flaming_pulsar safely swerve.
pixel871|Hit the gas|sircutry|Swerve|/u/pixel871 gets to call /u/sircutry a chicken.
