a.user|a.choice|b.user|b.choice|end
ellemarsh|Snitch|dan99990|Stay quiet|/u/ellemarsh gets freed for selling out /u/dan99990, who got 3 years.
mynameisclaire|Stay quiet|a5yl|Snitch|/u/a5yl gets freed for selling out /u/mynameisclaire, who got 3 years.
ctclif|Snitch|gandalftheultraviole|Stay quiet|/u/ctclif gets freed for selling out /u/gandalftheultraviole, who got 3 years.
maxitraxie|Stay quiet|internetadventurer|Stay quiet|Both /u/maxitraxie and /u/internetadventurer share a cell for one year.
apflamous|Snitch|dveo|Stay quiet|/u/apflamous gets freed for selling out /u/dveo, who got 3 years.
sovietvvinter|Snitch|mm1491|Snitch|Both /u/sovietvvinter and /u/mm1491 share a cell for two years.
vukrum|Stay quiet|dalibar|Stay quiet|Both /u/vukrum and /u/dalibar share a cell for one year.
spikethebunny|Stay quiet|dagsaroni|Stay quiet|Both /u/spikethebunny and /u/dagsaroni share a cell for one year.
elitepenguin4|Snitch|k_a_r_m_a_r_a|Snitch|Both /u/elitepenguin4 and /u/k_a_r_m_a_r_a share a cell for two years.
strattonschippers|Stay quiet|mistressliliana|Stay quiet|Both /u/strattonschippers and /u/mistressliliana share a cell for one year.
shel_bees|Stay quiet|joejoemojo|Stay quiet|Both /u/shel_bees and /u/joejoemojo share a cell for one year.
seriyes|Stay quiet|shaveslavers|Snitch|/u/shaveslavers gets freed for selling out /u/seriyes, who got 3 years.
there_be_segfaults|Stay quiet|co_lund|Stay quiet|Both /u/there_be_segfaults and /u/co_lund share a cell for one year.
fuckyou|Snitch|fewbike|Stay quiet|/u/fuckyou gets freed for selling out /u/fewbike, who got 3 years.
-rosemallow|Snitch|perntdoast|Snitch|Both /u/-rosemallow and /u/perntdoast share a cell for two years.
onlytoask|Snitch|crocostix|Snitch|Both /u/onlytoask and /u/crocostix share a cell for two years.
fallon758|Stay quiet|imsomature69|Stay quiet|Both /u/fallon758 and /u/imsomature69 share a cell for one year.
holyspirit_of_hell|Stay quiet|dream66_|Stay quiet|Both /u/holyspirit_of_hell and /u/dream66_ share a cell for one year.
davidthewalkerx|Snitch|rhazior|Stay quiet|/u/davidthewalkerx gets freed for selling out /u/rhazior, who got 3 years.
mentos68|Stay quiet|dermaxpower|Snitch|/u/dermaxpower gets freed for selling out /u/mentos68, who got 3 years.
coltonhoover|Stay quiet|steaknsteak|Stay quiet|Both /u/coltonhoover and /u/steaknsteak share a cell for one year.
dottydani|Stay quiet|87657467|Stay quiet|Both /u/dottydani and /u/87657467 share a cell for one year.
xtarification|Snitch|milliebirdie|Snitch|Both /u/xtarification and /u/milliebirdie share a cell for two years.
netherlewis|Snitch|alaskansky|Stay quiet|/u/netherlewis gets freed for selling out /u/alaskansky, who got 3 years.
pepsilover1|Stay quiet|thatwriterfriend|Stay quiet|Both /u/pepsilover1 and /u/thatwriterfriend share a cell for one year.
dragonheart000|Stay quiet|moovlin|Stay quiet|Both /u/dragonheart000 and /u/moovlin share a cell for one year.
-pikajew|Stay quiet|divineprince2|Snitch|/u/divineprince2 gets freed for selling out /u/-pikajew, who got 3 years.
ssabethh|Stay quiet|eyebrowsforeveryone|Stay quiet|Both /u/ssabethh and /u/eyebrowsforeveryone share a cell for one year.
the_future_is_wild|Stay quiet|skwrepb|Stay quiet|Both /u/the_future_is_wild and /u/skwrepb share a cell for one year.
arthuresque|Stay quiet|marceloardz|Snitch|/u/marceloardz gets freed for selling out /u/arthuresque, who got 3 years.
2spoogy|Stay quiet|numberlesswake|Stay quiet|Both /u/2spoogy and /u/numberlesswake share a cell for one year.
redpon3|Stay quiet|henricy|Stay quiet|Both /u/redpon3 and /u/henricy share a cell for one year.
cyberrubyfox|Snitch|cokeraddict|Stay quiet|/u/cyberrubyfox gets freed for selling out /u/cokeraddict, who got 3 years.
jaclekiller|Stay quiet|sammyterrybelzer|Snitch|/u/sammyterrybelzer gets freed for selling out /u/jaclekiller, who got 3 years.
nemesys2005|Stay quiet|tridentboy|Stay quiet|Both /u/nemesys2005 and /u/tridentboy share a cell for one year.
blmzd|Stay quiet|devilwearstoms|Stay quiet|Both /u/blmzd and /u/devilwearstoms share a cell for one year.
pablothemexican7|Stay quiet|keto-420|Stay quiet|Both /u/pablothemexican7 and /u/keto-420 share a cell for one year.
johnnysmart|Snitch|spfifle|Stay quiet|/u/johnnysmart gets freed for selling out /u/spfifle, who got 3 years.
bdazbty|Snitch|anesma|Stay quiet|/u/bdazbty gets freed for selling out /u/anesma, who got 3 years.
mrpilotgamer|Stay quiet|rhyschew|Snitch|/u/rhyschew gets freed for selling out /u/mrpilotgamer, who got 3 years.
finbarwrong|Snitch|facitcitro|Stay quiet|/u/finbarwrong gets freed for selling out /u/facitcitro, who got 3 years.
zoethor2|Snitch|xaplostras|Snitch|Both /u/zoethor2 and /u/xaplostras share a cell for two years.
unicornbomber|Stay quiet|andydandy162|Stay quiet|Both /u/unicornbomber and /u/andydandy162 share a cell for one year.
clony85|Stay quiet|skretsch|Stay quiet|Both /u/clony85 and /u/skretsch share a cell for one year.
xor50|Snitch|japasthebass|Stay quiet|/u/xor50 gets freed for selling out /u/japasthebass, who got 3 years.
toastyghostie|Stay quiet|boltkey|Snitch|/u/boltkey gets freed for selling out /u/toastyghostie, who got 3 years.
cabar93|Stay quiet|tlmb0|Stay quiet|Both /u/cabar93 and /u/tlmb0 share a cell for one year.
flsming_pulsar|Stay quiet|etherealphoenix|Stay quiet|Both /u/flsming_pulsar and /u/etherealphoenix share a cell for one year.
hollybv|Stay quiet|pohtahtoe|Stay quiet|Both /u/hollybv and /u/pohtahtoe share a cell for one year.
aberger|Stay quiet|adrimirc|Stay quiet|Both /u/aberger and /u/adrimirc share a cell for one year.
balletscience|Snitch|jacobepping|Stay quiet|/u/balletscience gets freed for selling out /u/jacobepping, who got 3 years.
thelastalliance|Snitch|firejoule|Stay quiet|/u/thelastalliance gets freed for selling out /u/firejoule, who got 3 years.
elvysaur|Snitch|hugesf|Snitch|Both /u/elvysaur and /u/hugesf share a cell for two years.
revnox|Stay quiet|1585881|Snitch|/u/1585881 gets freed for selling out /u/revnox, who got 3 years.
apoptopsicle|Stay quiet|lemmyk|Snitch|/u/lemmyk gets freed for selling out /u/apoptopsicle, who got 3 years.
newme274|Snitch|dinomannitro6|Stay quiet|/u/newme274 gets freed for selling out /u/dinomannitro6, who got 3 years.
evilsalmon|Stay quiet|pm_meyourcoffee|Snitch|/u/pm_meyourcoffee gets freed for selling out /u/evilsalmon, who got 3 years.
400_lux|Stay quiet|jompeter01|Stay quiet|Both /u/400_lux and /u/jompeter01 share a cell for one year.
betterphoneron|Snitch|therealsoulquarian|Snitch|Both /u/betterphoneron and /u/therealsoulquarian share a cell for two years.
summertime214|Snitch|nog00d|Snitch|Both /u/summertime214 and /u/nog00d share a cell for two years.
itsbentheboy|Stay quiet|pricelesshats|Stay quiet|Both /u/itsbentheboy and /u/pricelesshats share a cell for one year.
cpriper|Snitch|zantary|Snitch|Both /u/cpriper and /u/zantary share a cell for two years.
xdr-sr64|Stay quiet|p0tet|Stay quiet|Both /u/xdr-sr64 and /u/p0tet share a cell for one year.
mabrera|Stay quiet|jingah|Snitch|/u/jingah gets freed for selling out /u/mabrera, who got 3 years.
wjs12|Snitch|crappylaptop|Stay quiet|/u/wjs12 gets freed for selling out /u/crappylaptop, who got 3 years.
15goku|Snitch|flatulanceontoast|Stay quiet|/u/15goku gets freed for selling out /u/flatulanceontoast, who got 3 years.
unitconversion|Snitch|ravistay|Stay quiet|/u/unitconversion gets freed for selling out /u/ravistay, who got 3 years.
4rewq|Snitch|mrballoon_hands|Snitch|Both /u/4rewq and /u/mrballoon_hands share a cell for two years.
cg5|Snitch|emmzaa|Stay quiet|/u/cg5 gets freed for selling out /u/emmzaa, who got 3 years.
hangmanchamp|Snitch|chackk|Stay quiet|/u/hangmanchamp gets freed for selling out /u/chackk, who got 3 years.
jslev9|Snitch|gintarazimu|Stay quiet|/u/jslev9 gets freed for selling out /u/gintarazimu, who got 3 years.
tehgreenmc|Stay quiet|dwightallright|Stay quiet|Both /u/tehgreenmc and /u/dwightallright share a cell for one year.
smfullman|Stay quiet|gingersassy|Stay quiet|Both /u/smfullman and /u/gingersassy share a cell for one year.
flyingmonkeyssaymoo|Snitch|makingitpurple|Stay quiet|/u/flyingmonkeyssaymoo gets freed for selling out /u/makingitpurple, who got 3 years.
i-hate-orange|Stay quiet|skarm137|Stay quiet|Both /u/i-hate-orange and /u/skarm137 share a cell for one year.
redtheta|Snitch|stasibasiphobic|Stay quiet|/u/redtheta gets freed for selling out /u/stasibasiphobic, who got 3 years.
bowser0000|Stay quiet|redmanb|Stay quiet|Both /u/bowser0000 and /u/redmanb share a cell for one year.
briannasaurusrex92|Snitch|platonic_void|Stay quiet|/u/briannasaurusrex92 gets freed for selling out /u/platonic_void, who got 3 years.
angelwk|Stay quiet|macman241|Snitch|/u/macman241 gets freed for selling out /u/angelwk, who got 3 years.
pacificparticular|Stay quiet|ernestochelaclau|Stay quiet|Both /u/pacificparticular and /u/ernestochelaclau share a cell for one year.
public_compliance|Stay quiet|pohtahtohg|Stay quiet|Both /u/public_compliance and /u/pohtahtohg share a cell for one year.
the_kazaakplethkilik|Stay quiet|bear_cop|Stay quiet|Both /u/the_kazaakplethkilik and /u/bear_cop share a cell for one year.
seaweed62393|Snitch|rthztzfhuztfhu|Stay quiet|/u/seaweed62393 gets freed for selling out /u/rthztzfhuztfhu, who got 3 years.
statguy|Stay quiet|endemiclegacy|Stay quiet|Both /u/statguy and /u/endemiclegacy share a cell for one year.
incrediblestrawberry|Stay quiet|thatyahoo|Snitch|/u/thatyahoo gets freed for selling out /u/incrediblestrawberry, who got 3 years.
sircutry|Stay quiet|barebahr|Stay quiet|Both /u/sircutry and /u/barebahr share a cell for one year.
gonumen|Stay quiet|twitchy775|Stay quiet|Both /u/gonumen and /u/twitchy775 share a cell for one year.
macbeth554|Snitch|dirtydan413|Snitch|Both /u/macbeth554 and /u/dirtydan413 share a cell for two years.
chan1150|Stay quiet|spacejunk444|Snitch|/u/spacejunk444 gets freed for selling out /u/chan1150, who got 3 years.
imlikesocool|Snitch|pizzapieladida|Stay quiet|/u/imlikesocool gets freed for selling out /u/pizzapieladida, who got 3 years.
bobito5|Snitch|captain_cobra24|Stay quiet|/u/bobito5 gets freed for selling out /u/captain_cobra24, who got 3 years.
kashthealien|Stay quiet|scholar_requesting|Stay quiet|Both /u/kashthealien and /u/scholar_requesting share a cell for one year.
fire1299|Stay quiet|spectreshep|Stay quiet|Both /u/fire1299 and /u/spectreshep share a cell for one year.
survivevivrus|Snitch|youcalled911forthat|Stay quiet|/u/survivevivrus gets freed for selling out /u/youcalled911forthat, who got 3 years.
sofiboy|Stay quiet|vowelss|Snitch|/u/vowelss gets freed for selling out /u/sofiboy, who got 3 years.
zackattackz|Stay quiet|graviton_beam|Stay quiet|Both /u/zackattackz and /u/graviton_beam share a cell for one year.
songstressindistress|Stay quiet|goatcrew|Stay quiet|Both /u/songstressindistress and /u/goatcrew share a cell for one year.
throwaway133379001|Stay quiet|homoredditus|Stay quiet|Both /u/throwaway133379001 and /u/homoredditus share a cell for one year.
scayman223|Stay quiet|hushsquared|Stay quiet|Both /u/scayman223 and /u/hushsquared share a cell for one year.
alecksphillips|Stay quiet|brooke_girl|Stay quiet|Both /u/alecksphillips and /u/brooke_girl share a cell for one year.
moithirteen|Stay quiet|iminabox|Snitch|/u/iminabox gets freed for selling out /u/moithirteen, who got 3 years.
tyzon05|Stay quiet|nat-cat|Snitch|/u/nat-cat gets freed for selling out /u/tyzon05, who got 3 years.
rara623|Snitch|legosp7|Snitch|Both /u/rara623 and /u/legosp7 share a cell for two years.
drlucidreverie|Snitch|d3008|Snitch|Both /u/drlucidreverie and /u/d3008 share a cell for two years.
thomas6785|Snitch|highly-sammable|Stay quiet|/u/thomas6785 gets freed for selling out /u/highly-sammable, who got 3 years.
itcouldnotbeme|Snitch|pili_in_ibiza|Snitch|Both /u/itcouldnotbeme and /u/pili_in_ibiza share a cell for two years.
hellsing73|Snitch|pixel871|Stay quiet|/u/hellsing73 gets freed for selling out /u/pixel871, who got 3 years.
thewalkinggnome|Stay quiet|chthonicirrigation|Snitch|/u/chthonicirrigation gets freed for selling out /u/thewalkinggnome, who got 3 years.
redeyedchester|Stay quiet|theakkez|Snitch|/u/theakkez gets freed for selling out /u/redeyedchester, who got 3 years.
hypergraphia|Stay quiet|aguirre1pol|Stay quiet|Both /u/hypergraphia and /u/aguirre1pol share a cell for one year.
mwrowe92|Stay quiet|anotherturingmachine|Stay quiet|Both /u/mwrowe92 and /u/anotherturingmachine share a cell for one year.
grkpgn|Stay quiet|calibaan|Stay quiet|Both /u/grkpgn and /u/calibaan share a cell for one year.
jeray2000|Stay quiet|97ft|Stay quiet|Both /u/jeray2000 and /u/97ft share a cell for one year.
a_dam_ste|Stay quiet|amberlise|Stay quiet|Both /u/a_dam_ste and /u/amberlise share a cell for one year.
hunter5226|Snitch|spectral-k|Stay quiet|/u/hunter5226 gets freed for selling out /u/spectral-k, who got 3 years.
lordllamahat|Stay quiet|nephdaddy8|Stay quiet|Both /u/lordllamahat and /u/nephdaddy8 share a cell for one year.
not_a_plane_either|Stay quiet|swagmasterrs|Snitch|/u/swagmasterrs gets freed for selling out /u/not_a_plane_either, who got 3 years.
obzoen|Snitch|kaytydid|Stay quiet|/u/obzoen gets freed for selling out /u/kaytydid, who got 3 years.
the_aquacadet|Stay quiet|luctations|Stay quiet|Both /u/the_aquacadet and /u/luctations share a cell for one year.
nullomore|Snitch|kmrst|Snitch|Both /u/nullomore and /u/kmrst share a cell for two years.
ruschnav|Stay quiet|nstarz|Stay quiet|Both /u/ruschnav and /u/nstarz share a cell for one year.
bewaretwo|Snitch|cloneman95|Stay quiet|/u/bewaretwo gets freed for selling out /u/cloneman95, who got 3 years.
auramgold|Stay quiet|ameliabedelia7|Stay quiet|Both /u/auramgold and /u/ameliabedelia7 share a cell for one year.
usespython|Stay quiet|65rytg|Stay quiet|Both /u/usespython and /u/65rytg share a cell for one year.
nosdarb|Stay quiet|tkaish|Snitch|/u/tkaish gets freed for selling out /u/nosdarb, who got 3 years.
grosscoconuts|Stay quiet|edihau|Stay quiet|Both /u/grosscoconuts and /u/edihau share a cell for one year.
madsonl|Snitch|scubaduck|Snitch|Both /u/madsonl and /u/scubaduck share a cell for two years.
onesixtyseven|Stay quiet|avarangian|Stay quiet|Both /u/onesixtyseven and /u/avarangian share a cell for one year.
orthanit|Stay quiet|gresskarpai|Stay quiet|Both /u/orthanit and /u/gresskarpai share a cell for one year.
enjoyslongwalks|Stay quiet|altoidian|Stay quiet|Both /u/enjoyslongwalks and /u/altoidian share a cell for one year.
atagon1|Stay quiet|krtkneki|Stay quiet|Both /u/atagon1 and /u/krtkneki share a cell for one year.
backdoor_sliders|Snitch|noobhunter777|Stay quiet|/u/backdoor_sliders gets freed for selling out /u/noobhunter777, who got 3 years.
shining_|Snitch|smathering|Stay quiet|/u/shining_ gets freed for selling out /u/smathering, who got 3 years.
kerune|Snitch|femna|Stay quiet|/u/kerune gets freed for selling out /u/femna, who got 3 years.
amazinglyawesomename|Snitch|11111000000b|Snitch|Both /u/amazinglyawesomename and /u/11111000000b share a cell for two years.
_kissmexoxo|Stay quiet|cherryclackers|Stay quiet|Both /u/_kissmexoxo and /u/cherryclackers share a cell for one year.
